inhA	INH,Et
katG	INH
ahpC	INH
kasA	INH
ndh	INH
rpoB	RIF
pncA	PZA
embB	EMB
embC	EMB
embA	EMB
rmlD	EMB
gid	STR
fabG1	INH,Et
ethA	Et
ethR	Et
gyrB	MOX,OFL
gyrA	MOX,OFL
rpsL	STR
rrs	STR,K,CAP
tlyA	CAP
mshA	Et
Rv0678	BDQ
rplC	LZD
rpsA	PZA
thyA	PAS
Rv0340	INH
eis	K
iniB	EMB,INH
iniA	EMB,INH
iniC	EMB,INH
embR	EMB
fbpC	INH
Rv0340	INH
Rv1772	INH
furA	INH
fabD	INH
kasA	INH
accD6	INH
efpA	INH
fadE24	INH
nat	INH
folC	PAS
